37
12
..............A..........B..R.......R
.R.........B.........................
...A...................R.........R...
R.............B....B.................
..B.....................A.......B....
............R.....B..................
....R............A..................A
...........R.........A........R......
...........................A.........
.....R..........B..................B.
..RRAR.....B...........B...A.........
...RRR............R..............R...
